//MAP CONVERTED BY dmm2tgm.py THIS HEADER COMMENT PREVENTS RECONVERSION, DO NOT REMOVE
"a" = (
/turf/closed/mineral/rogue,
/area/rogue)
"b" = (
/obj/effect/decal/remains/human,
/obj/effect/decal/cleanable/dirt/cobweb,
/obj/item/restraints/legcuffs/beartrap/armed/camouflage,
/obj/item/clothing/cloak/raincloak/furcloak/black{
	pixel_x = 14
	},
/turf/open/floor/rogue/naturalstone,
/area/rogue)
"e" = (
/mob/living/simple_animal/hostile/retaliate/rogue/spider,
/obj/structure/spider/stickyweb,
/turf/open/floor/rogue/naturalstone,
/area/rogue)
"g" = (
/mob/living/simple_animal/hostile/retaliate/rogue/spider,
/obj/effect/decal/cleanable/dirt/cobweb,
/obj/item/storage/belt/rogue/pouch/coins/mid,
/turf/open/floor/rogue/naturalstone,
/area/rogue)
"h" = (
/obj/effect/decal/cleanable/dirt/cobweb,
/turf/open/floor/rogue/naturalstone,
/area/rogue)
"l" = (
/obj/item/clothing/under/roguetown/chainlegs/iron,
/turf/open/floor/rogue/naturalstone,
/area/rogue)
"n" = (
/turf/closed/mineral/rogue/bedrock,
/area/rogue)
"o" = (
/obj/effect/decal/remains/human,
/turf/closed/mineral/rogue,
/area/rogue)
"r" = (
/obj/item/restraints/legcuffs/beartrap/armed/camouflage,
/turf/open/floor/rogue/naturalstone,
/area/rogue)
"t" = (
/obj/item/ingot/iron,
/obj/item/ingot/iron,
/obj/item/ingot/iron{
	pixel_x = 11;
	pixel_y = -5
	},
/obj/item/ingot/iron{
	pixel_y = 4;
	pixel_x = 7
	},
/turf/open/floor/rogue/naturalstone,
/area/rogue)
"u" = (
/obj/item/storage/belt/rogue/leather/cloth,
/turf/open/floor/rogue/naturalstone,
/area/rogue)
"x" = (
/mob/living/simple_animal/hostile/retaliate/rogue/spider,
/turf/open/floor/rogue/naturalstone,
/area/rogue)
"y" = (
/turf/open/transparent/openspace,
/area/rogue)
"z" = (
/obj/item/roguestatue/iron,
/turf/open/floor/rogue/naturalstone,
/area/rogue)
"A" = (
/obj/item/clothing/suit/roguetown/shirt/grenzelhoft{
	pixel_x = -4;
	pixel_y = 19
	},
/obj/item/clothing/under/roguetown/grenzelpants{
	pixel_x = 10
	},
/obj/item/clothing/shoes/roguetown/grenzelhoft{
	pixel_x = -12;
	pixel_y = -13
	},
/turf/open/floor/rogue/naturalstone,
/area/rogue)
"C" = (
/obj/item/clothing/suit/roguetown/shirt/dress/gen/black,
/obj/item/clothing/cloak/apron/waist{
	pixel_x = 14;
	pixel_y = -8
	},
/turf/open/floor/rogue/naturalstone,
/area/rogue)
"D" = (
/obj/structure/spider/stickyweb,
/turf/open/floor/rogue/naturalstone,
/area/rogue)
"E" = (
/obj/effect/landmark/ambush,
/turf/open/floor/rogue/naturalstone,
/area/rogue)
"F" = (
/obj/effect/decal/cleanable/dirt/cobweb/cobweb2,
/turf/open/floor/rogue/naturalstone,
/area/rogue)
"G" = (
/obj/structure/spider/stickyweb,
/turf/closed/mineral/rogue,
/area/rogue)
"H" = (
/obj/item/roguecoin/copper/pile,
/turf/open/floor/rogue/naturalstone,
/area/rogue)
"I" = (
/obj/structure/spider/stickyweb/solo,
/turf/open/floor/rogue/naturalstone,
/area/rogue)
"J" = (
/obj/structure/spider/stickyweb,
/mob/living/simple_animal/hostile/retaliate/rogue/spider,
/turf/open/floor/rogue/naturalstone,
/area/rogue)
"K" = (
/obj/effect/decal/remains/human,
/turf/open/floor/rogue/naturalstone,
/area/rogue)
"L" = (
/turf/open/floor/rogue/naturalstone,
/area/rogue)
"M" = (
/obj/item/clothing/suit/roguetown/armor/cuirass/iron,
/turf/open/floor/rogue/naturalstone,
/area/rogue)
"N" = (
/obj/item/reagent_containers/food/snacks/rogue/bun_grenz{
	pixel_x = 14;
	pixel_y = 4
	},
/turf/open/floor/rogue/naturalstone,
/area/rogue)
"P" = (
/obj/structure/spider/stickyweb,
/obj/structure/spider/stickyweb,
/turf/open/floor/rogue/naturalstone,
/area/rogue)
"Q" = (
/obj/item/clothing/suit/roguetown/shirt,
/obj/item/clothing/suit/roguetown/shirt,
/obj/item/clothing/suit/roguetown/shirt,
/obj/item/clothing/suit/roguetown/shirt/rags,
/turf/open/floor/rogue/naturalstone,
/area/rogue)
"S" = (
/obj/effect/decal/remains/human,
/obj/structure/spider/stickyweb/solo,
/turf/open/floor/rogue/naturalstone,
/area/rogue)
"U" = (
/mob/living/simple_animal/hostile/retaliate/rogue/spider,
/obj/effect/decal/remains/human,
/turf/open/floor/rogue/naturalstone,
/area/rogue)
"V" = (
/obj/effect/decal/cleanable/dirt/cobweb/cobweb2,
/obj/item/clothing/head/roguetown/helmet/skullcap/grenzelhoft{
	pixel_y = -15
	},
/turf/open/floor/rogue/naturalstone,
/area/rogue)
"W" = (
/obj/effect/decal/remains/human,
/obj/effect/decal/cleanable/dirt/cobweb,
/obj/structure/spider/stickyweb/solo,
/turf/open/floor/rogue/naturalstone,
/area/rogue)
"Y" = (
/obj/item/clothing/under/roguetown/tights,
/turf/open/floor/rogue/naturalstone,
/area/rogue)
"Z" = (
/obj/effect/decal/remains/human,
/obj/effect/decal/cleanable/dirt/cobweb,
/turf/open/floor/rogue/naturalstone,
/area/rogue)

(1,1,1) = {"
n
n
n
n
n
n
n
n
L
L
L
n
n
n
n
n
n
n
n
n
"}
(2,1,1) = {"
n
L
L
L
L
L
L
L
L
L
L
L
L
L
L
L
L
L
L
n
"}
(3,1,1) = {"
n
L
L
L
L
L
L
L
a
L
a
a
a
L
L
L
L
a
L
n
"}
(4,1,1) = {"
n
L
a
a
o
a
L
a
o
L
L
L
L
L
a
a
L
a
L
n
"}
(5,1,1) = {"
n
L
L
a
b
L
L
a
Z
L
a
L
a
a
a
a
a
L
L
n
"}
(6,1,1) = {"
n
a
L
a
C
a
L
a
a
L
a
L
a
W
a
a
L
L
L
n
"}
(7,1,1) = {"
n
L
L
a
u
a
L
L
L
L
L
E
a
S
a
a
a
L
L
n
"}
(8,1,1) = {"
n
L
L
L
L
L
L
a
a
D
a
L
L
L
L
L
r
L
L
n
"}
(9,1,1) = {"
L
L
L
a
a
L
L
a
h
D
a
a
D
a
L
L
a
L
L
L
"}
(10,1,1) = {"
L
L
L
a
h
L
L
a
a
D
J
G
D
a
F
a
a
a
L
L
"}
(11,1,1) = {"
L
L
L
a
L
a
L
L
a
V
N
A
J
G
a
a
D
L
L
L
"}
(12,1,1) = {"
n
L
L
L
L
r
a
L
a
a
D
D
D
L
L
L
D
G
L
n
"}
(13,1,1) = {"
n
L
L
a
K
L
L
L
D
P
P
x
I
K
D
a
a
L
L
n
"}
(14,1,1) = {"
n
L
L
a
a
Q
Y
L
a
a
D
G
D
x
D
D
a
a
L
n
"}
(15,1,1) = {"
n
L
L
L
r
L
L
L
a
g
D
J
D
U
D
D
D
D
L
n
"}
(16,1,1) = {"
n
L
a
L
a
L
E
L
a
t
a
l
D
a
D
x
a
L
L
n
"}
(17,1,1) = {"
n
L
a
L
L
L
L
L
a
J
z
M
D
D
D
L
a
a
L
n
"}
(18,1,1) = {"
n
L
L
a
L
L
L
L
a
G
G
G
G
G
G
G
L
L
L
n
"}
(19,1,1) = {"
n
a
L
L
L
a
a
L
L
L
L
L
L
L
L
L
L
a
L
n
"}
(20,1,1) = {"
n
n
n
n
n
n
n
n
n
L
L
L
n
n
n
n
n
n
n
n
"}

(1,1,2) = {"
n
n
n
n
n
n
n
n
L
L
L
L
n
n
n
n
n
n
n
n
"}
(2,1,2) = {"
n
y
y
y
y
y
y
y
y
y
y
y
y
y
y
y
y
y
y
n
"}
(3,1,2) = {"
n
y
y
y
y
y
y
y
L
y
L
L
L
y
y
y
y
L
y
n
"}
(4,1,2) = {"
n
y
L
L
L
L
y
K
D
y
y
y
y
y
L
L
y
L
y
n
"}
(5,1,2) = {"
n
y
y
L
y
y
y
L
y
y
y
y
L
L
D
L
L
y
y
n
"}
(6,1,2) = {"
n
L
y
L
y
D
y
L
L
y
y
y
L
y
L
D
y
y
y
n
"}
(7,1,2) = {"
n
y
y
L
y
L
y
y
y
y
y
y
L
y
L
L
L
y
y
n
"}
(8,1,2) = {"
n
y
y
y
y
y
y
L
L
y
L
y
y
y
y
y
y
y
y
n
"}
(9,1,2) = {"
L
y
y
L
L
y
y
D
y
y
L
L
L
L
y
y
L
y
y
L
"}
(10,1,2) = {"
L
L
y
D
y
y
y
L
L
y
y
y
D
L
L
L
L
L
y
L
"}
(11,1,2) = {"
L
L
y
L
y
L
y
y
D
y
y
y
D
y
D
D
D
L
y
L
"}
(12,1,2) = {"
L
y
y
y
y
y
L
y
L
e
y
y
e
y
y
y
L
y
y
L
"}
(13,1,2) = {"
L
L
y
L
y
y
y
y
L
D
L
L
H
y
L
L
L
y
y
L
"}
(14,1,2) = {"
n
y
y
D
L
y
y
y
L
D
D
e
L
y
L
y
L
L
y
n
"}
(15,1,2) = {"
n
L
y
y
y
y
y
y
L
y
L
L
K
y
L
y
y
y
y
n
"}
(16,1,2) = {"
n
y
L
y
L
y
y
y
L
y
L
y
L
y
L
y
L
y
y
n
"}
(17,1,2) = {"
n
y
L
y
y
y
y
y
L
e
D
y
e
L
L
y
L
L
y
n
"}
(18,1,2) = {"
n
y
y
L
y
y
y
y
L
L
L
L
L
L
L
y
y
y
y
n
"}
(19,1,2) = {"
n
L
y
y
y
L
L
y
y
y
y
y
y
y
y
y
y
L
y
n
"}
(20,1,2) = {"
n
n
n
n
n
n
n
n
L
L
L
L
n
n
n
n
n
n
n
n
"}
